NO ./texture/no.xpm
SO ./texture/so.xpm
WE ./texture/we.xpm
EA ./texture/ea.xpm
F 220,100,0
C 225,30,0

11111
1   1
1 E 1
1   1
11111
